A lot of us take our parents for granted, and I've done that.::Многие из нас воспринимают своих родителей как должное, и я это сделал.
abandoned::заброшенный
abdomen::брюшная полость
abdominal::брюшной
abducted::похищено
abduction::похищение
abide::Соблюдать
abide::терпеть
abode::местопребывание
abstinence::Воздержание
abuse::злоупотребление
abused::злоупотребляли
accident::случайность
accidental::Случайный
acclaimed::известный
accolade::акколада
accused::обвиняемый
acquaintance::знакомство
acute::острый
adamant::непреклонный
adjourned::откладывать
administer::Управлять
admirable::замечательный
adorable::обожаемый
advocated::выступал
afar::далеко
affable::приветливый
affair::дело
affair::Интимные отношения
affection::привязанность
affinity::близость
agitates::возбуждать
Ah, God dang it!::Ах, черт побери!
ailments::недуги
airborne::бортовой
aisle::придел
alert::готовность
alimony::алименты
allegation::утверждение
alleged::мнимый
allies::союзники
allure::очарование
alms::милостыня
altercations::ссоры
altogether::вообще
alumnus::выпускник
Ambiguous::двусмысленный
ambush::засада
ambushed::подстерегли
amid::среди
amiss::неладно
ammunition::боеприпасы
amuse::веселье
amused::довольный
And I could've used the help.::И мне бы не помешала помощь.
and mind my own business?::и не лезть не в свое дело?
And out of that comes, what?::И из этого выходит, что?
And that ain't a pretty sight::И это не очень красивое зрелище
And then I figured it out.::А потом я все поняла.
And then I... I used to do,::А потом я... Раньше я делал,
And this is what it would look like if cocaine had a face.::И вот как это выглядело бы, если бы у кокаина было лицо.
And you're acting like a jerk, and you know you can get away with it.::И ты ведешь себя как придурок, и ты знаешь, что тебе это сойдет с рук.
ankle::лодыжка
anterior::передний
antimony::сурьма
anxious::озабоченный
Anyhoo::Так или иначе
apace::быстрыми темпами
ape::кривляться
appalled::потрясенный
appalling::ужасающий
apparel::одежда
apparently::по всей видимости
appealing::привлекательный
appraisal::оценка
apprehensive::понятливый
Argumentative::спорный
arousal::возбуждение
arraignment::предъявление обвинения
arsenic::мышьяк
arson::поджог
aspersions::клеветать
aspirations::стремления
aspire::стремиться
assassinate::убивать
assault and battery::рукоприкладство
assessment::оценка
asset::актив
astute::проницательный
asylum::убежище
atoning::искупительная
attended::участие
attending::посещение
attic::чердак
auspicious::благоприятный
Avarice::Алчность
avert::предотвращать
awkward::неловкий
azure::лазурный
bachelor party::Мальчишник
backbone::основа
Badgering::Придирки
bagels::бублики
bagpipes::волынки
Bail::Залог
bait::приманка
ballistic::бешеный
balm::бальзам
baloney::ерунда
bang::взрыв
banter::стеб
barely::еле
barf::блевать
bargain::сделка
barge::врываться
barley::ячмень
barnacles::ракушка
barrel::бочка
bastard::незаконнорожденный
bathtub::ванна
be commended unto God.::да будет хвала Богу!
beacon::маяк
beads::Бисер
beagle::гончая
beastly::животный
beatings::побои
Because if I didn't set it on fire, it would've definitely set me on fire.::Потому что если бы я не подожгла ее, она бы определенно подожгла меня.
beg::умолять
begets::породит
begging::нищенство
begrudge::завидовать
begrudge::пожалеть
begrudge::поскупиться
behalf::от имени
behalf::поручение
beiges::цвет беж
belches::рыгать
belly::живот
benefactor::благодетель
benevolence::доброжелательность
benign::доброкачественный
berated::ругал
bereaved::скорбящий
beseechingly::умоляюще
beset::осаждают
Beside::Рядом
bestiality::скотство
betcha::дык
betrayal::предательство
beverage::напиток
biased::тенденциозный
biassed::пристрастный
big nutrition research scandal sees 6 more retractions, purging popular diet tips::большой скандал исследования питания видит еще 6 ретракций, очищая популярные советы диеты
Big whoop, I'm out of a job.::Очень важно, я без работы.
bile::желчь
bitter::горький
bizarre::эксцентричный
blackmail::шантажировать
bladder::мочевой пузырь
bland::ласковый
blanket::одеяло
blaring::рев
blast::взрыв
blatant::вопиющий
blatantly::демонстративно
bleach::отбеливатель
blemish::Порок
bless::благословить
blinker::поворотник
blinker::шоры
blip::отметка
bliss::блаженство
blitzing::разгромить
blizzard::метель
bluff::блефовать
blushing::застенчивый
bogus::фиктивный
boils::фурункул
bollocks::ерунда
bolsters::боковые валики
bond::связь
bonding::склеивание
boost::увеличение
booze::выпивка
boozing::пьянство
boring::скучная
bosom::пазуха
bouncer::вышибала
bounty::дар
BOW::ЛУК
bowel::кишечник
brace::обхватить
brace::подпереть
brace::распорка
bran::отруби
brass::латунь
brawl::драка
breach::Нарушение
bribe::взятки
brim::край
bronco::мустанг
brought up::воспитан
buck::самец
bucked::взбрыкнул
Buckle::Пряжка
buckled::пристегнутый
buds::рецепторы
bugging::прослушивание
bullocks::волы
bully::задира
bum::задница
bump::удар
Bunkie::сосед
burden::бремя
burping::отрыжка
bust::арестовать
but he was gone, so...::но его больше не было, так что ... ..
But I do write songs, and every once in a while, I'm asked,::Но я пишу песни, и время от времени меня спрашивают,
but I'm afraid your wife has a bit of a point.::но я боюсь, что ваша жена имеет некоторое значение.
But where was I to go?::Но куда мне было идти?
but, what exactly are we agreeing to?::но на что именно мы соглашаемся?
butchering::разделка
butler::дворецкий
Butterball::Пышечка
bygones::в прошлом
bylaws::устав
bystander::свидетель
cackle::кудахтать
cackles::хихикать
cadavers::трупы
cadence::модуляция
cagey::Скрытный
cahoots::сговоре
calcify::кальцинировать
calculous::калькулезный
candid::Откровенный
cane::трость
canvases::холсты
cape::плащ
capped::ограничен
capricious::капризный
capricorn::Козерог
cardiac arrest::остановка сердца
cardinal::кардинальный
carnage::бойня
carnation::гвоздика
carol::воспевать
carriage::перевозка
cart::тележка
carted::возили
catering::общественное питание
catnip::кошачья мята
Cause they'll get you on either end of this.::Потому что они поймают тебя на обоих концах.
cautious::осторожный
ceaseless::непрестанный
cemetery::кладбище
cereal::каша
chalk::мел
chambermaid::горничная
chap::парень
charges::обвинение
chariot::колесница
charred::Обугленный
chasm::пропасть
chef::шеф-повар
cherish::лелеять
cherishing::заботы о
chest::грудная клетка
chestnut::каштан
chimes::звенеть
CHIMING::ЗВОН
CHIRPING::ЩЕБЕТАНИЕ
chiseled::отделанный
choked::подавился
choking::душащий
CHOKING::задыхающийся
chores::хлопоты
chortles::сдавленный смех
chortles::хихикать
chowder::густая похлебка
chubby::круглолицый
chuck::зажимной патрон
chums::корешами
clacking::треск
claimed::заявленный
clam::моллюск
clamoring::требуя
clandestine::тайные
CLANGING::ЗВОН
clasp broke::застежка сломал
classifieds::объявление
CLATTERS::клацанье
cleanse::очищать
cleavage::расщепление
clergy::Духовенство
climbed::поднялся
cling::цепляться
clingy::цепкий
clodding::засорение
cloddish::неуклюжий
clogged up::забитый
clogs::сабо
clot::сгусток
clot::тромб
clotted::свернувшийся
clotting::свертывание
clover::клевер
clumped::слипаются
cobbling::починка обуви
cochlear::улитковый
cockeyed::абсурдный
cocky::дерзкий
coerced::принужденный
cognizant::знающий
collar::воротник
colloquially::разговорный
colluding::вступать в сговор
colon::двоеточие
colon::толстая кишка
combative::воинственный
come up::подойти
commandeered::реквизировали
commendation::благодарность
commended::рекомендовать
commitment::обязательство
committed::приверженной
committed::совершать
compel::принуждать
compelled::вынужденный
compelling::неотразимый
compelling::убедительные
compels::принуждает
composure::хладнокровие
compounded::смешивать
compounding::рецептура
compromising::компрометирующий
compulsive::заядлый
conceal::скрывать
conceived::задуманный
conceptis::первичная задача
concerned::относиться
concrete::бетон
concurs::выражает согласие
concussion::сотрясение
condemned::осужденный
condescension::снисхождение
conduct::поведение
cone::конический
confess::исповедоваться
confess::признавать
confession::признание
confessions::признание
confident::уверенная в себе
confine::ограничивать
confines::пределы
conflagration::конфликт
confused::запутывать
congestion::перегруженность
conjugality::супружество
conman::жулик
conned::Обманутый
connoisseur::знаток
conondrum::головоломка
consent::разрешение
consent::согласие
consign::перепоручать
Consistently::Последовательно
conspiracy::заговор
conspirators::заговорщик
conspiring::вступление в сговор о совершении преступления
contagious::заразительный
contemplation::созерцание
contemplative::созерцательный
contender::соперник
contest::конкурс
contested::оспариваемый
contradicton::противоречие
controversial::спорный
convene::созывать
Convent::Монастырь
conveyed::транспортируемый
convicted::Осужденный
conviction::убеждениеe
convince::убеждать
Convincer::убеждение
convincing::убедительно
convoluted::извилистый
cooties::вши
Copacetic::В порядке
cope::справиться
copper::медь
copycat::подражатель
corkscrews::штопоры
corneal::роговичный
corny::банально
Corporal::Ефрейтор
cot::койка
counsel::Совет
counseling::консультация
counter::прилавок
counterinsurgency::противоповстанческой
courage::мужество
courtesy::Вежливость
coward::трус
cowardly::трусливый
coy::застенчивый
cozy::уютный
cozying::заигрывание
cradle::колыбель
cramming::переполняющий
cramps::колики
cranberry::клюква
cranial::черепной
cranking::проворачивание
cranky::капризный
crapper::сортире
cratered::кратерами
craving::страстное желание
crawl::ползать
crawled::подполз
CREAKING::СКРИПУЧИЙ
credibility::авторитет
creepiness::жуткий характер
creepy::жуткий
creepy::ползучий
crimson::краснеть
crinkle::завивать
cripple::калечить
critter::твари
croaks::сдохнуть
crooked::изогнутый
crooners::эстрадный певец
cropped up::всплыло
crucifix::распятие
cruel::жестокий
crux::суть
cuckold::рогоносец
cues::подсказки
cunning::хитрость
curb::бордюрный камень
curriculums::программа
cushy::легкий
custodial::тюремным заключением
custodians::Хранители
custody::опека
custody::под стражей
cutthroat::беспощадный
cyst::киста
dabbing::нанесение
dabble::плескаться
dainty::лакомство
dangle::мотаться
dare::рискнуть
dare::сметь
Darn::подери
darn::проклятый
darting::стремительный
dashing::лихой
dates::даты
dawn::рассвет
dawned::осенить
dead::нечувствительность
deadbeat::неплательщики
deadbeats::неплательщики
deadening::заглушать
deaf::глухой
debacle::катастрофа
debauched::развратный
decaf::без кофеина
decapitated::обезглавленный
decathlon::десятиборье
deceased::умерший
decency::порядочность
decent::порядочный
deception::обман
deceptive::мошеннический
decipher::расшифровывать
declaring::декларирование
decorated::награжденный
deductible::подлежащий вычету
deems::считает
defamation::клевета
defeat::поражение
deferred::отложенный
defrauded::обманывать
deliberately::сознательно
delineating::очерчивающий
delirium::бред
Deliverance::освобождение
Deliverance::Спасение
deluded::заблуждаются
delusion::галлюцинация
delusion::наваждение
delusional::бредовый
demeanor::поведение
demise::кончина
den::логово
deprive::лишать
deputy::заместитель
Deputy::помощник
deranged::ненормальный
derided::высмеянный
derogatory::уничижительное
derringer::карманный пистолет
descend::сходить
desirous::жаждущий
desperate::безнадежный, отчаянный
detained::задержанный
detention::задержание
deteriorating::ухудшается
detestable::отвратительный
detrimental::вредный
deuce::двойка
devious::хитрый
deviousness::изворотливость
devising::разработки
dew::роса
diaper::подгузник
dice::кости
did Bill Clinton take you up on your offer?::Билл Клинтон принял ваше предложение?
diddle::надувать
diddle::тратить
digest::переваривание
digestive::пищеварительный
dilated::расширенный
diligence::трудолюбие
Diminish::Умалять
diminishment::уменьшение
dimwit::тупица
dip::погружение
disappointments::разочарования
disarray::беспорядке
discharge::освобождение
discreet::сдержанный
disguise::маскировать
disguising::маскировка
disgusting::отвратительный
disheartening::обескуражить
dishonesty::нечестность
disillusioned::разочаровался
Dislocated::Вывихнутый
dismiss::увольнять
dismissed::отклонил
dispatched::отправленный
dispel::рассеять
disrespect::неуважение
disrupt::нарушать
disruption::разрушение
disruptive::разрушительный
dissolves::растворимый
distracted::отвлекается
distractible::отвлекаемый
distracting::отвлекающий
distraction::безумие
distress::страдание
disturbed::тревожить
ditch::ров
ditched::угробил
divine::божественный
divinity::божественность
dizziness::головокружение
dizzy::голова кружится
doable::выполнимый
docile::послушный
docket::краткое содержание документа
domestic::домашний
domicile::постоянное местожительство
dork::придурок
dormant::бездействующий
dormant::спящие
dorsal::спинной
doughboy::пехотинец
dove::Голубь
downer::депрессант
dowsed::поливаются
drain::осушать
drawer::выдвижной ящик
drawn::привлекать
drips::капает
drizzles::моросит
drool::млеть от счастья
droop::свисать
drowning::утопление
drudgens::гоблин
drywall::гипсокартон
duct::проток
ductus::тракт
Due diligence.::Должная осмотрительность.
due diligence::экспертиза
due::из-за
dull::скучный
dumbwaiter::кухонный лифт
dumped::сбрасывали
dumpster::мусорку
dung::навоз
dunk::замочить
duped::обманутый
duvet::Пуховое одеяло
dweeb::слабак
dwell::жить
dwell::обитать
dwelling::жилище
earl::граф
earmuffs::наушники
earnest::серьезный
edema::отек
eden::Эдем
eerie::сверхъестественный
either::любой
elbowed::коленчатый
eligible::право
eloped::скрывшийся
elusive::неуловимый
embalming::бальзамирование
embark::ввязываться
embark::начинать
embarrassed::смущенный
embezzled::Присвоенный
embody::воплотить
embraced::охваченный
emerge::появляться
enamored::без ума
encore::бис
endanger::подвергать опасности
endeavor::попытка
endorse::одобрять
endorsement::одобрение
endure::терпеть
engagement::обязательство
engorged::наполненный
engraved::выгравированный
engrossing::всепоглощающий
enlightening::поучительный
entrails::внутренности
envy::зависть
epic::грандиозный
epiphany::Богоявление
equine::конский
equity::капитал
eradicate::искоренить
Erstwhile::прежде
escrow::депонирование
establishments::учреждения
estranged::раздельно проживающий
eulogy::панегирик
evaporated::Испарился
Even though it doesn't have the means to start fires.::Даже если у него нет средств, чтобы разжечь огонь.
eventually::в итоге
everlasting::вечный
evicted::выселенный
eviction::изгнание
evildoers::грешник
evildoers::злодей
evolved::развиваться
exalt::превозносить
exasperated::раздраженный
excavation::земляные работы
excerpt::отрывок
excommunicated::Отлученный от церкви
excruciating::мучительный
excursions::экскурсии
exempted::освобождены
exemption::освобождение
exhausting::изнурительный
exile::изгнанник
Exorbitant::Непомерный
expediency::целесообразность
expedited::ускоренное
expel::выгонять
expulsion::выталкивание
Exsanguinate::Обескровить
exterminate::изводить
exterminator::истребитель
extort::вымогать
extortion::поборы
extricate::выпутываться
fabulous::сказочный
fainted::упал в обморок
fair::объективный
fair::Справедливая
faith::вера
fangs::клыки
fart::пердеть
fatter::жирнее
faucet::кран
feasible::выполнимый
feast::пир
feather::перо
feisty::энергичный
felony::преступление
felt-tip::фломастер
fended::отразила
fern::папоротник
ferociously::свирепо
ferry::паром
fertility::плодовитость
Fertilizer::Удобрение
fetal::эмбриональный
feud::вражда
feverish::лихорадочный
fiddling::возиться
fiddling::пустячный
fierce::ожесточенные
fierce::свирепый
filler::наполнитель
filth::гадость
filthy::мерзкий
fiscal::финансовый
flagellant::садомазохист
flagged::попадает
flailing::молотить
flaked::хлопьевидный
flap::хлопать
flared::клеш
flatline::выровняться
flattering::лестный
flaxen::льняной
flicking::быстрого перемещения
flinch::вздрогнуть
flip::кувырок
flipped::переворачивать
flock::стадо
floozy::шлюха
flopped::шлепнулся
flung::разветвленная
flustered::взволнованный
foil::помешать
fold::сложить
folded::сложенный
folds::складывать
footage::съемки
foramen::отверстие
Forehead::Лоб
forensic::судебный
forensics::криминалист
forfeit::лишаться
forged::формировать
Forgery::Подделка
forgivable::простительный
formidable::грозный
Fornicating::Прелюбодействующий
fortitude::стойкость
foster::приемный
foster::способствовать
foster::стимулировать
foul::нарушать
fowl::живность
fraction::часть
fractured::сломанный
fragrant::душистый
frantic::неистовый
fraternity::братство
fray::потёртости
freaked out::испугался
fricking::задолбали
fritter::оладья
frivolous::несерьезно
frock::платье
frosting::глазурь
Fudge::Выдумка
fugitive::беглец
fuming::дымящийся
fungal::грибковый
fungus::грибок
furnishings::мебель
futile::бесполезный
futility::никчемность
fuzzy::нечеткий
gabbing::болтовня
gains::доход
gait::походка
gall::желчь
gangbusters::вполне достойно
gargles::полощет
garish::кричаще
garment::одежда
gasping::затрудненное дыхание
gasps::задыхаться
gauze::марля
gavel::молоток
gear::шестерня
geez::Боже
gems::жемчужина
generous::великодушный
Get off of me.::Отвали от меня.
getaway::побег
getaway::уходи
giddy::легкомысленный
giggle::хихикать
gimmick::диковинка
ginger::имбирь
Give me the circumstances-- -When do I go off?::- Назови мне обстоятельства ... - когда я уйду?
give up::сдаваться
glands::железа
gleaned::подбирала
glibness::бойкость
glimmer::мерцание
glitch::глюк
glitter::блестеть
gloat::злорадствовать
gloating::злорадствует
glorious::великолепный
glorious::восхитительный
glow::пылать
gluteus::ягодичная мышца
goat::козел
goatee::эспаньолка
goofball::придурок
Gophers::Суслики
Got anything back there?::Есть что нибудь там?
gown::платье
grabble::ползать на четвереньках
grace::благодать
Grace::Изящество
gracious::милостивый
graft::трансплантат
grappled::разрешить
grasping::хватательный
gratifying::приятный
gravel::гравий
grease::смазка
greasy::сальный
grief::горе
grievance::жалобы
grieve::огорчать
grieve::скорбеть
grin::усмешка
grind::молоть
grinding::измельчение
grindstone::точильный камень
grip::рукоятка
groan::стон
GROANING::СТОНУЩИЙ
groggy::непрочный
groin::пах
grovel::пресмыкаться
grubby::неряшливый
grudge::зависть
Grudges::Обиды
grunting::ворчать
grunting::крякать
GRUNTING::кряхтеть
grunting::хрюканье
GRUNTS::мычать
Guess that's it then.::Полагаю, на этом все.
Guess where I'm going?::Угадай, куда я направляюсь?
Guess where I'm going?::Угадай, куда я направляюсь?
guilt::вина
guise::вид
guise::предлог
gulp::глоток
gulping::глотание
gunslinger::стрелок
Gurgling::Бульканье
gurgling::булькающий
gut::внутренность
gut::потрошить
guts::кишки
gutted::Выпотрошенный
gyp::мошенник
Hallmark::Визитная карточка
hallway::коридор
hamper::мешать
hamstrings::подрезать крылья
hamstrings::сухожилия
handcuffs::наручники
handed off::передано
handkerchief::носовой платок
handle::ручка
handover::передача полномочий
handsome::красивый
hang on::подожди
hangover::Похмелье
harassed::притеснять
harassment::притеснение
harboring::укрывательство
harlot::Блудница
harsh::суровый
harshly::резко
hauling::тянущий
Have her meet me there.::Пусть она встретит меня там.
Have you had coffee yet today?::ты уже выпил кофе сегодня?
hawker::разносчик
haze::дымка
He doesn't have to like it::Ему это не должно нравиться.,
he had to hang it up.::ему пришлось повесить трубку.
He is getting off easy.::Он легко отделается.
He wouldn't start that early, seven in the morning. And...::Он не начинал так рано, в семь утра. И...
Hearsay::домыслы
hearse::катафалк
heather::вереск
heave::волнение
heck::какого черта
Heck::черт
heckling::прерывание
hectoring::запугивание
hedge::страховка
heist::Ограбление
hep::осведомленный
hepatic::печеночный
Here you go.::Вот, держи.
herniated::грыжа
herniating::выпячивание
heyday::расцвет
hiccup::икота
hickey::штуковина
hilarious::умора
hillbilly::деревенский
hip::тазобедренный
hips::бедра
hissy::истерика
hitman::наемный убийца
hiv::ВИЧ
hoard::копить
hoarder::накопитель
hoarding::накопительство
hoarse::хриплый
holistic::комплексный
holler::окликать
homage::дань
honcho::шеф
Honestly, I wasn't even told. I just kind of knew.::Честно говоря, мне даже не сказали. Я просто знал.
honor::честь
Hood::Капюшон
hoof::копыто
hookers::проститутками
hookup::соединение
hordes::Орда
hosed::вырубил
hosed::поливает
hosed::порешить
hosing::шланги
hospitality::гостеприимство
hostage::заложник
hostility::враждебность
hot tub::джакузи
hovering::парящий
How does a man sit on a piano?::Как человек сидит на пианино?
How high has it gone?::Как высоко она поднялась?
How is she not named Bertha? I don't get it.::Почему ее не зовут Бертой? Я не понимаю.
How quaint.::Как странно.
How's it going, Jerry? -How you doing?::привет, как дела, Джерри? - Как поживаешь?
hubby::муженек
hug::объятие
humility::скромность
Humility::Смирение
humpty dumpty::Шалтай-Болтай
hunch::догадка
hunch::ломоть
hung::повесить
hussy::потаскушка
hypertension::гипертония
hypochondriac::ипохондрик
hypocrisy::лицемерие
hypocrite::лицемер
I am having a different experience. That's for sure.::У меня другой опыт. Это совершенно точно.
I am having a different experience. That's for sure.::У меня другой опыт. Это совершенно точно.
I can't abide, it's waste.::Терпеть не могу, это пустая трата.
I don't know if he's that good.::Я не знаю, настолько ли он хорош.
I got another one. Let me try this. Okay. Here we go.::У меня есть еще один. Позвольте мне попробовать. Окей. оба-на.
I got to look at some guy's hoof.::Я должен посмотреть на копыто какого-то парня.
I let it slip.::Я проговорился об этом.
I look over at Marty, whom I don't really know, and he's writing a note.::Я смотрю на Марти, которого на самом деле не знаю, и он пишет записку.
I never get lonesome::Мне никогда не бывает одиноко .
I pretty much got everything I wanted.::Я получил все, что хотел.
I say we call it a night.::Я предлагаю закончить на сегодня.
I think it more has to do with the phrase white people.::Я думаю, что это больше связано с фразой  белые люди.
I think keep a low profile.::Думаю, не высовывайтесь.
I thought I could tough it out::Я думал, что смогу пережить это
I used to do that bit on that.::Раньше я так и делал.
I wasn't ready to tell anybody.::Я не был готов никому рассказать.
I would like a cup of coffee. I'll have an herbal tea.::- Я бы хотел выпить чашечку кофе. - Я буду травяной чай.
I'd be hard-pressed to say::Мне было бы трудно сказать
If you think of anything.::Если что нибудь вспомнишь.
I'll be right there.::Я сейчас подойду, пожалуйста.
I'll swing by.::Я заскочу к тебе.
I'm all pissed off. I have to deal with that.::Я совсем разозлилась. Я должен с этим разобраться.
I'm gonna look that up.::Я собираюсь проверить это.
I'm like, I won't change anything. I'm an artist. It'll go in the way it is.::Я такой: я ничего не изменю. Я художник. Все пойдет так, как есть.
I'm sorry that you're not gonna like what I'm about to say,::Мне жаль, что тебе не понравится то, что я собираюсь сказать,
imbues::пропитывает
immature::незрелый
immense::огромный
immensely::очень
impact::влияние
impaired::ослабленный
impediment::препятствие
impeding::препятствующий
impersonate::олицетворение
impersonation::олицетворение
impersonator::самозванец
impetus::импульс
implications::значения
impostor::самозванец
In awe of me::В благоговении передо мной
inane::бессмысленный
inauspisious::благоприятный
incentive::стимул
inception::момент создания
incisions::разрезы
inclined::склоняюсь
incoherently::бессвязно
inconclusive::неубедительный
incubated::вынашивать
Indemnity::возмещение убытков
indispensable::незаменим
indisposed::нездоровый
indulge::баловать
inequities::неравенство
inevitable::неизбежный
inexorably::неумолимо
inexplicable::необъяснимый
infamous::позорный
infidelity::неверность
inflamed::воспаленный
inflammation::воспаление
Inflammatory::подстрекательский
inflection::интонация
infractions::нарушения
infringement::нарушение
infusion::инфузии
ingobernable::Подлежащий обложению
ingrained::укоренившийся
ingrate::неблагодарный
inhibited::тормозится
injunction::предписание
inkling::догадка
innit::не так ли
inoculated::засевают
insane::ненормальный
insanity::невменяемость
insatiable::ненасытный
instant::мгновенный
insufferable::невыносимый
insult::оскорбление
insulting::оскорбительный
insurgency::мятеж
insurgents::боевики
insurmountable::непреодолимый
intercourse::общение
interference::вмешательство
interim::промежуточный
intermittent::прерывистый
interrogate::допрашивать
interrogation::допрос
intestinal::кишечный
intestine::кишка
intestines::кишечник
intimidated::запугали
intimidating::пугающим
intractable::неподатливый
intricate::замысловатый
invasion::вторжение
invasive::агрессивный
inveiglement::обольщение
involuntary::невольный
inward::внутрь
irritable::раздражительный
Is it that it's better to leave well enough alone, avoid confrontation?::Разве лучше оставить в покое, избежать конфронтации?
Is that what you did? Those were your two examples?::Это то, что ты сделал? Это были ваши два примера?
It doesn't feel like me, Tracy. It doesn't--::Это не похоже на меня, Трейси. Это не--
It feels weird for me to say it.::Мне странно это говорить.
itches::чешется
itching::зудящий
itchy::зудящий
It's a lot of debt.::Это большой долг.
It's a miracle we ever got any work done::Это чудо, что мы когда-либо делали какую-либо работу
It's called Let's Keep the Minimum Wage Right Where She's At.::Это называется  давайте Сохраним минимальную зарплату там, где она есть.
It's even got your grade point average up there.::Там даже Средний балл за твою оценку.
It's the last one. It was the last one.::Это последнее. Это был последний раз.
I've evolved, clothing wise...::Я эволюционировал, одевая мудро...
I've gone up there in a bad mood.::Я поднялся туда в плохом настроении.
ivy::плющ
Jab::Удар
jackals::шакалы
janitor::дворник
jar::банка
jaunty::бойкий
jaw::зажим
jaywalking::переходил в неположенном месте
jealous::ревнивый
jealousy::ревность
Jeez::Здорово
jeopardize::угрозу
jeopardy::подсудность
jerk::придурок
jiff::миг
jiggle::трясти
joints::суставы
jolly::веселый
jolted::встряхнул
judgment::осуждение
jug::кувшин
juggler::жонглер
juggling::жонглирование
jumbled::перемешаны
junkie::наркоман
just going like this.::вот так все и происходит.
just the underworld types::только типы преступного мира,
juxtaposition::сопоставление
kale::листовая капуста
kettle::чайник
kiboshed::когда с тобой расправились
kickoff::начало
kidney::почка
kinship::родство
knapsack::ранец
kneecaps::наколенники
knit::вязать
knot::узел
KNUCKLES::сустав
kombucha::чайный гриб
lace::шнурок
laden::нагруженный
lagging::отстает
laid::положенный
lame::хромой
lampoon::пасквиль
lap::круг
Larceny.::Воровство.
Larry Miller used to do a funny thing about, people would say,::Ларри Миллер обычно делал забавные вещи, люди говорили,
lashed out::набросился
lashing::порка
laxatives::слабительные
leaflet::листовка
Leaflets::Листочки
lean::опираться
leans::наклоняется
leap::прыжок
lease::сдавать в аренду
leash::привязь
lechery::разврат
ledger's::бухгалтерская книга
legume::боб
lenient::Снисходительный
leper::прокаженный
lesion::поражение
leverage::рычаг
liability::обязательство
libel::Клевета
libelous::клеветнические
licorice::лакрица
lid::крышка
ligible::право
Like no days had passed.::Как будто не прошло и дня.
Like, these guys used to race, and there would be fans standing::Мол, эти ребята раньше гоняли, а там стояли бы болельщики
likelihood::вероятность
liken::схожим
limelight::ярко осветить
limp::хромать
linger::задерживаться
linger::оставаться
lining::выравнивание
liter::литр
litigation::судебный процесс
Little gentle here. Well, I'll just leave it like that.::Немного нежен здесь. Ну, я просто оставлю все как есть.
loaders::погрузчики
loathe::чувствовать отвращение
loathsome::Отвратительный
loitering::праздношатание
loophole::лазейка
loopholes::амбразуры
looting::мародерство
lousy::паршивый отвратительный
lucid::ясный
lucky you::повезло тебе
lucrative::прибыльный
lumber::пиломатериалы
lumberjacks::лесорубы
lump::кусковой
lung::легкое
lupus::волчанка
lure::приманка
mackerel::макрель
magenta::пурпурный
maiden::дева
malfeasance::недобросовестность
malice::злоба
malice::злой умысел
malicious::Злой
malignancy::злокачественность
manhunt::преследование
mansion::дом
maroon::бордовый
marrow::костный мозг
martyr::мученик
mascot::талисман
Mash::Пюре
mature::зрелый
May I say I would not be here on stage tonight if not for you.::Могу я сказать, что я не был бы здесь сегодня вечером, если бы не ты.
mayhem::нанесение увечья
meager::скудный
mean::подлый
meddle::вмешиваться
meddling::надоедливый
medevaced::эвакуирован
mediocre::бездарно
medley::смесь
menorah::семисвечник
mere::простой
meticulous::дотошный
milled::фрезерованные
millipede::многоножка
misdemeanor::проступок
miserable::несчастный
misers::Скряга
misery::нищета
misery::страдание
mishap::Неудача
misogynist::женоненавистник
misogynistic::женоненавистнический
misplaced::неуместны
missus::благоверная
mitigate::смягчать
mitigate::смягчать
moan::стонать
moaning::стон
mock::издеваться
mocking::осмеяние
modest::скромный
mojo::амулет
mojo::харизмы
mold::плесень
mole::моль
molested::приставал
money trouble a while back?::проблемы с деньгами некоторое время назад?
mongrel::дворняжка
moony::мечтательный
morass::болото
morose::угрюмый
mortgage::ипотека
mortuaries::морги
motto::девиз
MOURNFUL::СКОРБНЫЙ
mourning::траур
mousse::пена
moxie::дерзость
MUFFLED::ЗАКУТАННЫЙ
MUFFLED::приглушенный
mugged::ограбленный
mumbling::бормотание
muse::размышление
mustache::усы
mustard::горчичный
mutilation::увечье
My friend and I used to do all these check takes.::Мы с другом делали все эти чеки.
napkin::подгузник
naughty::непослушный
nauseous::тошнотворный
neat::аккуратный
neater::аккуратный
need you to round me up::нужно, чтобы ты меня окружил.
needy::нуждающийся
negligence::небрежность
niche::ниша
nightcap::колпак
nipping::щиплющий
nipple::ниппель
nipples::соски
No, that's not why.::Нет, не поэтому.
noddy::простак
nodules::узелки
nody::тело
nostril::ноздря
notch::засечка
notions::понятия
notorious::печально известный
notwithstanding::несмотря на
Now let's beg to differ on that one.::Теперь давайте попросим не соглашаться.
Now you're fleshing it up quite a bit.::Теперь ты его совсем немного портишь.
Now you're fleshing it up quite a bit.::Теперь ты его совсем немного портишь.
nozzle::сопло
nugget::самородок
nuisance::неприятность
numb up::онемение вверх
numb::оцепенелый
numbness::онемение
nurture::взрастить
nuts::чокнутый
oath::присяга
obedience::послушание
obey::подчиниться
obeyance::повиновение
Objection::Возражение
obligation::обязательство
obliged::обязанный
oblique::косой
oblique::уклончивый
obnoxious::противный
obscurity::неясность
observant::наблюдательный
obsession::одержимость
obstinacy::упрямство
obtrusive::навязчивость
odd::странный
oddbod::странный
odds::шансы
of the masters of mankind.::повелителей человечества.
offender::правонарушитель
offending::Оскорбление
Oh, sure, we'll have you back.::О, конечно, мы вернем тебя обратно.
Oh, yeah? Jeez.::О, правда? Здорово.
Okay, hang tight.::Хорошо, держитесь крепче.
ominous::угрожающий
omission::упущение
omniscience::всеведение
oozing::сочащийся
oppression::угнетение
opt::выбирать
opting::выбирают
ordeal::тяжелое испытание
orderlies::санитары
origin::происхождения
ornery::отвратительный
outlay::расходы
outlive::пережить
outpouring::излияние
outraged::возмущен
outrageous::возмутительный
outrank::превосходить
outward::наружу
oven mitts::рукавицы
overachiever::сверхуспевающим
overbearing::властный
overcome::преодолеть
overhead::верхний
overly::слишком
overreacted::переусердствовал
overreaction::чрезмерная реакция
Overruled::Отменено
overturned::опрокинулся
owe::задолжать
pacemaker::кардиостимулятор
paddle::весло
paddle::лопатка
paddling::перемешивание
pageant::карнавальное шествие
palatable::аппетитный
palliative::смягчающий
pally-wally::дружище-растяпа
palpitation::сильное сердцебиение
pamper::баловать
pancreas::поджелудочная железа
PANTING::ЗАДЫХАЮЩИЙСЯ
parakeet::Попугай
paratroop::десантник
parcels::участок
parlor::салон
passover::Пасха
patted::обыскивать
paw::лапа
pawn::закладывать
payback::расплата
payout::выплата
peasants::крестьяне
peckers::клювы
peel::корка
peers::сверстники
pellagra::пеллагра
pelvic::тазовый
pelvis::таз
pep::бодрость духа
peppermint::мята
peppy::бодрый
perception::восприятие
perceptive::проницательный
perfunctory::Поверхностный
perjury::лжесвидетельство
perk::привилегия
perks::дополнительные льготы
perks::надбавки
perky::самоуверенный
Perp::Преступник
perpetual::вечный
persistent::настойчивый
persuasive::убедительный
pertinent::уместен
petal::лепесток
petrified::окаменевший
petrosal::височной
petty::мелкие
petulance::нетерпеливость
physicist::физик
pickle::пикули
pickles::маринад
pimp::сутенер
pin::булавка
pinching::щипание
pinned::приколол
pitch::подача
Pitchfork::Вилы
pituitary::гипофиз
pity::жалость
pivot::reference
plague::чума
plains::равнина
plaintiff::истец
plaintiffs::истцы
plaque::доска
plaques::бляшки
platelet::тромбоцит
platelets::тромбоциты
platitudes::пошлостей
plausible::правдоподобный
plea::заявление
pleaded::взмолился
pleased::довольный
pleases::нравиться
pled::оправдываться
pledges::Закладывает
pledges::объявленные взносы
plow::плуг
plowed::вспахивать
plowing::вспашка
plucked::ощипанный
Plumbers::сантехник
plumed::украшенныйперьями
plump::пухлый
plunging::падающий
poachers::браконьеры
poignant::мучительный
Poised::Готова
poised::держать
Poised::приготовиться
poised::сбалансирован
polio::полиомиелит
poll::голосование
poop::изнурять
pop::шипучка
popsicle::фруктовое мороженое
popsicles::фруктовое
postpone::откладывать
postponing::отсрочка
postulant::соискатель
posture::позировать
potassium::калий
pottery::керамика
poultry::домашняя птица
pouting::надуть
poverty::бедность
precinct::участок
preciousness::ценность
precluded::препятствовать
preconceived::предвзятый
predicament::затруднительное положение
preempted::выгружаться
preference::предпочтение
prejorative::бранный
premature::преждевременный
premise::помещение
premise::предпосылка
premises::предпосылки
preoccupied::озабоченный
prerequisite::необходимое условие
pretend::делать вид
pretending::претендующий
pretext::отговорка
pretzels::крендельки
pride::гордость
pristine::нетронутый
privy::причастный
Probably what you're doing.::Вероятно, то, что вы делаете.
probationary::испытательный
proclivities::поползновения
prodigal::блудный сын
profanes::светский
proficient::опытный
projectiles::снаряды
prom::выпускной
promote::содействовать
prone::склонный
propel::приводить в движение
propensity::склонность
prophetically::пророчески
props::собственность
prosecuted::преследоваться
prosecution::судебное преследование
prospers::преуспевает
prowling::праздношатание
proximity::близость
proxy::доверенное лицо
prunes::чернослив
pry::Подглядывать
psychotic::психотик
puberty::половое созревание
pubes::лобок
puddle::барахтаться
puke::блевать
puke::тошнить
pull off::выдернуть
pulmonary::легочный
pummeling::избивая
punchline::кульминационный
puncture wounds::колотые раны
puncture::прокол
punitive::штрафной
purse::кошелек
purview::компетенции
puss::кошечка
quads::квадрицепс
quail::перепел
quaint::необычный
queer::странный
quirky::странный
quirky::ушлый
quivering::дрожащий
rabid::неистовый
rag::тряпка
RAGGEDLY::Неровно
ragout::рагу
ragweed::амброзия
rake::сгребать
rallied::сплоченный
rammed::таранить
rampant::угрожающий
ramshackle::ветхий
rancid::прогорклый
ransacked::разграбленный
ransom::выкуп
rascal::подлец
rash::сыпь
rattled::смущать
rattling::дребезжание
raucous::грубый
raw::чувствительный
reap what you sow.::пожнете то, что посеяли.
reason::довод, резон, аргумент
reasonable::разумный
reassess::пересмотреть
rebar::арматура
rebellion::восстание
recant::отречься
recap::резюме
receptionist::секретарь в приемной
reciprocity::взаимность
reckless::опрометчивый
recklessly::опрометчиво
reckoned::считаться
reclaim::истребовать
recluse::отшельник
reconcile::примириться
reconciliation::согласование
reconnaissance::разведывательный
recruiting::наем
recumbent::лежачий
redecorated::переоформить
redemption::выкуп
reek::вонь
referral::направления
reflux::отлив
refractory::строптивый
refrain::воздерживаться
rehab::восстановление
rehearsal::репетиция
rehearsing::репетировать
relapsing::рецидивирующий
remedy::средство
reminisce::предаваться воспоминаниям
remitting::ремитирующего
renal::почечный
rendition::исполнение
repay::погашать
repercussion::отзвук
replenish::пополнять
Representing the tribe, in a way.::Представляя племя, в некотором смысле.
repulsive::отталкивающий
repurposing::перепрофилирование
rescued::спасенный
resent::негодовать
resentment::чувство обиды
residual::остаточный
residue::вычет
resign::в отставку
resignation::отставка
resolution::разрешение
resounding::безоговорочный
restrain::сдерживать
resuscitate::Реанимировать
retainer::держатель
retaliation::воздаяние
RETCHES::РЫГАЕТ
retching::рвота
reticence::немногословность
retraced::откатилась
retractions::сокращение
retreat::отступление
retreating::удаляться
RETREATING::удаляться
reunion::собрание
reuptake::обратный захват
revamp::переоборудования
revelation::откровение
REVELATOR::НОСИТЕЛЬ ОТКРОВЕНИЙ
revenge::жажда мести
revival::возрождение
revving::увеличивать
rhino::носорог
rib::ребро
ribbon::лента
ribs::ребра
riddance::избавление
riddles::загадки
rigged::подтасованы
rigged::сфальсифицированными
righteous::праведный
riot::необузданность
rite of passage::обряд посвящения
rivalry::соперничество
robust::крепкий
rogues::жулье
roller-coaster::американские горки
roost::насест
rosary::Четки
ruled out::исключено
ruptured spleen::разорванная селезенка
ruptured::разрываются
ruse::хитрость
rush::порыв
rust::ржавчина
rusted::ржавый
RUSTLING::ШЕЛЕСТ
rut::борозда
sabbath::суббота
sack::постель
sage::мудрец
saline::солевой
savant::ученый
Saved::спасшийся
savior::спаситель
sayeth::говорит
scabbed::коростового
scam::мошенничество
scamp::негодяй
scamps::негодяев
scandalous::скандальный
scapegoats::стрелочники
scar::шрам
scarce::скудные
scarcer::дефицитный
scars::рубцы
scathing::хлесткие
scattered::разбросанный
schmuck::чмо
scofflaw::нарушитель
scoffs::насмешки
scold::поругать
scoop::воздухозаборник
scoot::удирать
scored::набрал
scouting::разведка
scraping::очистка
scratch::царапина
screeching::визжащий
scribbled::набрасывать
scrotum::мошонка
scrub in::втирать
scrubbed::шероховатый
scumbags::подонки
seal::печать
securing::обеспечивающий
seduced::соблазненный
seduction::соблазн
segue::переходить
seizing::захват
seizure::конфискация
seizure::припадок,приступ 
self-esteem::самооценка
selfish::эгоистичный
selfishness::эгоизм
senile::дряхлый
sensations::острые ощущения
sensualist::чувственный
serum::сыворотка
set off::отправляться
setbacks::неудачи
Setting me up...::Подставил меня...
settle::обосноваться
settle::угомониться
settling::урегулирования
sewer::канализация
sews::шьет
Shackles::наручники
shagging::трахает
shaky::шаткий
shallow::мелкий
shatter::раздробить
sheath::оболочка
shed::навес
shenanigans::махинация
shivering::дрожание
shlub::жлоб
shoddy::низкосортный
shore::берег
shove::пихать
shovel::лопата
shoving::толкание
showy::эффектный
shred of regret::толика сожаления
shrimp::креветки
SHUDDERING::ДРОЖАЩИЙ
shudders::содрогается
shuffling::шарканье
shysters::авантюристов, уголовников
SIGHING::ВЗДЫХАЮЩИЙ
sinister::Зловещий
sip::глоток
sipping::потягивающий
skew::наклон
skimp::экономить
skirmish::стычка
skirt::юбка
slain::убиенных
slam::хлопать
slammed::захлопнул
slamming::хлопанье
SLAMS::захлопывать
slaughter::убой
sleaze::аморальности
sleeves::рукав
slide::скольжение
slipped::поскользнулся
slipping::скользящий
slips::квитанция
slob::неряха
sloppy::Неряшливый
slumber::дремать
slur::пятно
SLURPING::хлюпать
slurring::нечленораздельно
smack::хлопать
SMACKS::чмоканье
small pox::оспа
smallpox::оспа
smear::мазок, клевета
smirking::ухмыляясь
smother::душить
smuggled::заниматься контрабандой
smuggling::контрабанда
snap::щелчок
snapped::щелкнул
SNAPPING::ЩЕЛКАЮЩИЙ
sneak::подкрадываться
sneak::ябеда
sneakers::кроссовки
sneaking::закрадывается
sneaky::подлый
sneering::насмешливый
snide::ехидный
sniffles::шмыгать носом
sniffling::сопение
snip::надрез
snort::фыркать
snorted::фыркнул
snowballing::лавинообразный
snubbed::пренебрежительно
snuggled up::прижимались
So, now I got to get a guy to come out,::Итак, теперь я должен найти парня, чтобы выйти,
So, the white liberals did what they tend to do when there's a confrontation.::Итак, белые либералы сделали то, что они, как правило, делают, когда есть конфронтация.
So, when they're called white people, some aren't used to that.::Поэтому, когда их называют белыми людьми, некоторые к этому не привыкли.
soaked::пропитанный
sobbing::рыдание
sober::трезвый
sobriety::трезвость
sodium::натрий
solace::утешение
soldiering::военная служба
solemn::торжественный
solicit::выпрашивать
solicitor::адвокатом
soluble::растворимый
solvent::состоятельный
SOMBER::МРАЧНЫЙ
Some of that has to do with my preconceived notions and fears::Некоторые из них связаны с моими предвзятыми понятиями и страхами
sophisticated::изощренный
sophomore::второкурсник
sorcerer::колдун
Sore::больной
sorest::больное
sourdough::закваска
spades::пики
spanked::шлепала
spanking::трепка
speck::пятнышко
speckles::крапинками
speech::речь
spew::блевать
spiking::с шипами
spine::позвоночник
spit::слюна
spleen::селезенка
spoiled::испорченный
sponging::паразитировать
sporadically::эпизодически
spousal::супруга
spouse::супруг
spree::кутеж
sprinkled::посыпают
spun::крученый
spunk::дерзость
spurned::отвергнутый
spurs::шпора
sputtering::треск
SPUTTERING::шипение
sputters::шипеть, трещать
sputum::мокрота
squabbles::дрязги
squad::команда
squak::Пронзительный крик
SQUEAKING::СКРИП
SQUEAL::ВИЗГ
SQUELCHING::ХЛЮПАЮЩИЙ
squirm::извиваться
squirming::извиваться
squirt::струя
squirting::разбрызгивание
squirts::струи
stabbed::заколол
stain::пятно
stained::запятнанный
stains::разводы
stake::доля
stall::стойло
stammering::заикание
stammers::заикается
STAMMERS::заикаться
stance::позиция
staph::стафилококк
staple::скоба
startle::испугать
stash::копить
statute::Устав
statutory::обязательный
steamroller::паровой каток
Steep::Обрыв
stem::стебель
sterling::безукоризненный
sternum::грудина
sticking::придерживающийся
sticking::торчащий
stickler::приверженец
stiff::жесткий
stiffed::кинул
stigma::клеймо
Still punching the clock, huh?::Еще есть время, да?
stipulate::предусматривать
stitches::швы
stoned::под кайфом
stoner::торчок
stoop::крыльцо
straddle::перешагивать
STRAINING::НАПРЯЖЕНИЕ
stranded::скрученный
strangled::Задушен
strap::ремень
straps::тесемки
straw::солома
streaked::пронесся
strep::стрептококк
stretch::протяжение
stubborn::упертый
stumbling::преткновение
stumped::озадачить
stunts::трюки
STUTTERS::ЗАИКАЕТСЯ
submission::материал
submissive::покорный
subpoena::вызов в суд
subsequently::впоследствии
SUBSIDES::СПАДАЕТ
subsiding::ослабевать
subsidy::субсидия
substantial::существенный
subterfuge::уловка
succulent::сочный, мясистый
suck up::подлизываться, всасывать
suckers::сосунки
suction::всасывание
suction::отсос
suffocate::задыхаться
suggestive::наводящий
suitor::кавалер
sulk::дуться
superstitions::суеверия
supple::податливый
surmise::предположение
Surmise::Предположение
surmount::преодолевать
surrender::Сдача
surrogates::суррогаты
surveillance::наблюдение
susceptibility::восприимчивость
suspect::подозреваемый
suspense::неизвестность
suspension::подвеска
suspension::приостановление
Sustained::поддерживать
sustained::устойчивый
swab::мазок
swaddling::пеленание
swallowed::поглотила
swamp::болото
swamped::завален
sway::склонить
swell::выпуклость
swell::зыбь
swell::опухать
swelling::припухлость
swine::свинья
swollen::раздутый
swooned::умирая
syllable::Звук, слог
sympathies::симпатии
syringe::шприц
tackle::снаряжение
tacky::липкий
tailor::портной
tailored::специально
tainted::замараны
takeoff::снимать
tan::загар
tangent::касательный
tantrum::вспышка гнева
taunted::насмехался
taupes::серо-коричневые
tearing::разрывающий
tease::дразнить
Tell her I'm heading back::Скажи ей, что я возвращаюсь
temper::характер
temporal lobe::височная доля
tempt::искушать
temptation::искушение
tenant::арендатор
tentacles::щупальца
tenth::десятая часть
tenth::десятый
tenuous::незначительный
tenuous::разреженный
tenure::срок пребывания
testament::завещание
testify::давать показания
testifying::показания
testimonial::отзыв
testimonial::рекомендация
testy::вспыльчивый
that that has ever been expressed.::это когда-либо было выражено.
that that has ever been expressed.::это когда-либо было выражено.
that urged caution::это требует осторожности
That you laughed at that makes me very disappointed in you.::Что тебя засмеют, что я очень разочарован в тебе.
That'll keep them out.::Это будет держать их подальше.
That'll keep them out.::Это будет держать их подальше.
That's a semicolon. -I'm gonna look that up.::-Это точка с запятой. - Я собираюсь проверить это.
That's gonna be a bit of a stumbling block in the hospitality field.::Это будет своего рода камнем преткновения в сфере гостеприимства.
That's got to be bad luck.::Это должно быть плохая примета.
That's it for me then.::Тогда для меня все кончено.
That's my point! That's what I've been saying.::Это моя точка зрения! Это то, что я говорил.
That's swell.::Это здорово.
the due diligence?::должная осмотрительность?
The only reason we know it's there is that we feel it.::Единственная причина, по которой мы знаем, что это есть, это то, что мы это чувствуем.
The same charming locale?::Та же очаровательная местность?
The stand-up has been great.::Стендап был великолепен.
thee::тебя
Then we'd have them walk around large estates.::Тогда мы заставим их ходить по большим поместьям.
thence::оттуда
There in a jiff.::Там в мгновение ока.
There you go.::Вот так вот.
There you go.::Вот, держи.
thereby::тем самым
There's a car out front.::Есть автомобиль.
There's a point? Look, I can talk just as well holding this cup::В этом есть смысл? Слушай, я могу говорить так же хорошо, держа эту чашку
There's that, too. You gotta straddle the line.::И это тоже имеет значение. Ты должен переступить черту.
These are rarely, if ever, seen private photos.::Это редко, если когда-либо, видели частные фотографии.
thingy::штуковина
This is how this will play out:::Вот как это будет играть:
thong::плеть
Those are great.::Они великолепны.
Thought I could tough it out,::Думал, что смогу справиться с этим.,
threspassed::нарушители
threw up::стошнило
thrill::волнение
throbbing::пульсация
THUDS::СТУКИ
thugs::головорезы
thy::твой
thyroid::щитовидная железа
thyself::себя
tick::поставить галочку
ticker::маятник
tide up::Привязан
tide::волна
tightwad::скряга
tillable::пригодный для пахоты
tinder::трут
tinfoil::фольга
tinkle::звяканье
tip-off::конфиденциальная информация
tipping::чаевые
tippled::пьянствовать
tipsy::навеселе
tissue::ткань
toddler::ребенок
toe::палец ноги
toiling::трудившийся
tomb::могила
tone::интонация
topple::падать
torment::мучение
tormented::мучиться
torn::разорванный
torque::крутящий момент
torsion::кручение
toss::бросать
tosses::подбрасывает
toughening::закалка
toupee::парик
tousled::взлохмаченный
traction::тяговый
trainspotting::игле
transfusion::переливание
Transgressions::правонарушение
transient::преходящий
transitioning::переход
traps::ловушка
treadmill::беговая дорожка
treasure::собирать и хранить
treat::лечить
tremendous::невероятный
tribal::родовой
tribes::племена
tricked::обманутый
trickle::струйка
Troll::распевать
tucking::Подобрав
tumble::кувыркаться
tummy::животик
tumor::опухоль
turds::дерьмо
turn on::включить
turnpike::большак
tush::тьфу
TWANGS::протяжный звук
tweaking::тонкая настройка
tweezer::пинцет
twiddle::вертеть
tycoon::магнат
ulcer::язва
umpire::судейский
umpteenth::энный
Uncanny::Жуть
uncanny::сверхъестественный
uncharted::неизведанный
unconscious::без сознания
undergone::подвергнутый
undermine::подрывать
underrated::недооцененный
underwhelming::восторг
underwhelming::посредственный
unfaithful::вероломный
unfertilized::неоплодотворенный
ungracious::нелюбезный
unilateral numbness::одностороннее онемение
unintelligible::непонятный
uninviting::непривлекательный
unknowingly::по незнанию
Unleash::дать волю
unleash::Развязывать
unmercifully::немилосердно
unravel::распутывать
unsavoury::непривлекательный
untrustworthy::ненадежный
upbeat::приподнятый
upbringing::воспитание
uphold::Поддерживать
uppity::чванный
upset::расстроен
upsetting::тревожный
upstanding::добропорядочный
upwards::больше
urged::убеждать
urges::побуждение
utmost::предельный
vacate::покидать
vagrant::бродяга
vague::рассеянный
vaguer::расплывчатым
vascular::сосудистый
vaults::своды
vehemence::горячность
vein::вена
veneer::облицовка
vengeful::мстительный
venomous::ядовитая
ventricle::желудочек
ventriloquist::чревовещатель
venue::место
verge::край
vessel::судно
vessels::сосуды
vest::жилет
vexed::раздосадованный
vials::флаконы
vigil::бдение
vile::мерзкий
vilify::поносить
villain::злодей
villains::злодеи
volition::хотение
vomit::рвотное
vortex::водоворот
vulnerable::уязвимый
wad::кусок
wading::болотная
wager::пари
waggle::покачивать
walrus::морж
wander::заблудиться
wandered::бродить
wanton::беспричинный
ward::подопечный
warmth::тепло
warrant::ордер
warranted::гарантия
wax::воск
waxed::вощеной
weakens::ослабляет
weakling::слабак
wean::отвыкать
weary::усталый
weave::петлять
weed::сорняк
weepy::плаксивый
weird::странный
we'll give you a holler.::мы дадим вам знать.
Well, I prob'ly could::Ну, я небось бы
Well, I'll give it a go. See, what happens is...::Хорошо, я попробую это сделать. Видишь, что происходит...
Well, now you're being cruel.::Ну, теперь ты ведешь себя жестоко.
We're the aliens you don't deport.::Мы инопланетяне, которых вы не депортируете.
we've been playing to draw.::мы играли на ничью.
We've come a long way. I don't give a fuck.::Мы проделали долгий путь.Мне на это наплевать.
whack::сильный удар
whacked::измотанный
What a day for a baguette.::Какой день для багета.
what else is there?::что еще здесь может быть?
What is it about it?::О чем это он?
what is the point of you?::какой вообще от тебя прок?
What would that have done?::Что бы это изменило?
whatnot::дребедень
What's that old quote, that...::Что это за старая Цитата, что?..
What's the saying?::Что ты хочешь этим сказать?
wheat::пшеница
whelmed::подавлять
When you're doing what?::Когда ты что будешь делать?
Whereas you may not... -Oh, no, I--::- В то время как Вы не можете... -О, нет, я--
whether::будь то
Which is why it's not really working out.::Вот почему это на самом деле не работает.
whimpering::Хныканье
whimpers::хнычет
whimsical::причудливый
whine::ноют
whining::нытье
whip::кнут
whiplash::ремень кнута
whirring::жужжание
WHIRRING::ЖУЖЖАЩИЙ
whiz::молодчина
Who could say what creates mood? Mood is a thing that's just there.::Кто бы мог сказать, что создает настроение? Настроение-это то, что есть.
whooping::гиканье
Why is tipping done as if we're not supposed to be doing it?::Почему чаевые делаются так, как будто мы не должны этого делать?
wicked::грешный
widen::расширять
wielding::владеющий
wig::парик
wilderness::пустыне
will be thrilled::будет в восторге
Will wonders never cease?::Чудеса никогда не прекратятся?
Will wonders never cease?::Чудеса никогда не прекратятся?
willing::готов
willingly::охотно
wily::хитрый
wimp::слабак
windpipe::трахея
wired::подключенный
withdrawal::вывод
withdrawals::изъятия
withdrawn::отозваны
withdrew::отозвала
withheld::неудержался
withholding::удержание
witty::остроумный
womb::матка
wonder::удивляться
wondering::интересоваться
wooed::посватался
woofs::гавканья
wore out::изнашивалась
workaround::обход
wrath::гнев
wreaking havoc::сея хаос
wreck::развалина
wrecked::разрушенный
wrench::гайковерт
wrestling::борьба
wuss::слабак
yanked::дернул
yelling::вопящий
YELLS::кричать
yells::кричит
yelping::визжать
yoke::иго
You do know that?::Вы действительно это знаете?
You had been around. You were fairly sophisticated. How old were you?::Вы были поблизости. Ты был довольно изощренным. Сколько тебе было лет?
You have to have a talent.::У тебя должен быть талант.
You have to have a talent.::У тебя должен быть талант.
You know when you're like an adult child and pushing your limits with your parents.::Ты знаешь, когда ты как взрослый ребенок и раздвигаешь границы со своими родителями.
You know, he was Irish. So there was a lot of...::Знаешь, он был Ирландцем. Так что их было много...
You know, is there any way?::Знаешь, есть какой нибудь способ?
you made that up.::ты все это выдумала.
You seemed like, Yes, come, my child. I've got this all figured out.::Ты выглядела так: да, пойдем, дитя мое. У меня есть все, что нужно.
you're in charge::вы отвечаете
you're in search of no good::ты не ищешь ничего хорошего
yuletide::святки
zaftig::пышными
still the first one last one this is it::по прежнему первый последний вот и все


reverend::почтенный
gimp::калека
shriller::попронзительнее
spruce::ель
spruce::нарядный
plucking::выщипывание
grim::мрачный
reaper::жнец
hoodies::балахоны
deposition::показание
unfathomable::непостижимый
apprentice::начинающий
detriment::ущерб
profits::прибыль
shtick::фокус
mover::инициатор
doer::исполнитель
mind::разум
can go on to become what it once was::может стать тем, чем когда то был
probably 18, on and off::возможно, 18, время от времени
the neighborhood was kind of sketchy not very safe, even::район был немного сомнительным даже не очень безопасно
sketchy::подозрительный
he is a chip off the old block::он обломок старого квартала
lavishly::щедро
emblazoning::украшающей
conservatively::скромно
how rich can you get?::* насколько богатым ты можешь стать?
inevitably::неизбежно
defining::определяющий
he also needed favors from us::он также нуждался в нашей помощи
brag::хвастаться
scrutiny::изучение
he was forced to acknowledge that he had lied::он был вынужден признать, что солгал
because he had everything to gain from using the notoriety,::потому что у него было все, чтобы получить от использования известности,
notoriety::известность
humongous::огромный
frankly::откровенно
clapping::аплодисменты
belief::понимание
reckon::рассчитывать
strapped::привязанный
swore::клясться
that he didn't have to rely on junk bonds::что ему не нужно полагаться на ненужные облигации
secured::обеспеченный
outrage::возмущение
adept::знаток
so, it doesn't matter what happens he's gonna take an event,::так что не важно, что произойдет он собирается принять участие,
blew::разнести
it's unlikely the shuttle gets sold::маловероятно, что шаттл продадут
barbara, other people owe money far in excess of what their assets are::барбара, другие люди должны денег намного больше, чем их активы
vault::хранилище
mean::подлый
had he not screwed it up::если бы он не облажался
allowance::разрешение
ubiquitous::вездесущий
darling::любимец
i thought that questions that you were posing to people in my organization::я думал, что вопросы, которые вы задаете людям в моей организации
survivor::переживший
those imbeciles! haven't they got any eyes?::эти имбецилы! разве у них нет глаз?
huckster::торгаш
o'brien he was essentially reduced to being a huckster::он был практически сведен к тому, чтобы быть барыгой
traction::сцепление
savvy::понимать
meddled::вмешиваться
apprenticeship::ученичество
seized::схваченный
raked::разгребать
dubious::сомнительный
impute::приписывать
hustler::жулик
solemnly::торжественно
litigations::тяжбы
that is wildly successful, it is the exact opposite::это дико успешно, это полная противоположность
nestled::приютившийся
notoriously::известно
discerning::разборчивый
plaster::пластырь
seize::схватить
fragrance::аромат
so many people who were left with their hand out::так много людей остались с протянутой рукой
and it really took off::и он действительно взлетел
foreclosure::выкуп
susceptible::восприимчивый
reprimanded::отчитывать
you're going to get paid it's just tough "::ты получишь свои деньги это просто жесть "
stunt::трюк
ramifications::последствия
defendant::подсудимый
settle::решить
divest::лишить
departed::уходить
summoned::вызванный
recess::перерыв
clubbed::забили
bludgeoned::дубасить
grabbed::хватать
cradling::укачивать
and off he went::и он ушел
unnerved::нервировать
admitted::признанный
sought::желаемый
slayings::убийства
then i have a great model over here, so i think things are gonna work out::тогда у меня есть отличная модель, так что, думаю, все получится
that he has been set up,::что его подставили ,
that it was a hell of a story::что это была адская история
i think ted regarded me as somebody to be manipulated or used in his cause::думаю, тед считал меня человеком, которым можно манипулировать или использовать в своих целях
it just seemed like a good story, either way it went::в любом случае, это казалось хорошей историей
and i knew that nobody else to that point had any access to him::и я знал, что никто другой не имел к нему доступа
reached::достигнутый
death row's not any fun::в камере смертников не весело
superficially::неглубоко
bundy people perceive me differently from how i perceive myself::люди воспринимают меня иначе, чем я сам себя воспринимаю
thrumming::бренчащим
roaming::разгуливать
marble::мрамор
bulging::выпуклый
murky::темный
pond::водоем
teased::подразнить
he just couldn't quite get the hang of doing::он просто не мог наловчиться делать
ted was the one to be dealt with,::тед был единственным, с кем нужно было иметь дело,
blowhard::хвастун
outcast::изгой
he just didn't seem to be all there, all present::он просто не казался всем присутствующим
with the notion that there is cause and effect::с понятием, что есть причина и следствие
uneasy::беспокойный
dependable::надежный
substantive::существенный
bobbing::качающийся
weaving::петлять
aloof::в стороне
personable::представительный
pledge::обещание
offended::раздражать
delinquents::правонарушители
assertiveness::уверенность в себе
vortman ted always fit in, wherever he was at::тед всегда вписывался, где бы он ни был
and, uh, ted could always strike up a dialogue::и тед всегда может начать диалог
newsworthy::заслуживающий
i'm embarrassed that i should be getting this publicity from it::мне стыдно, что я получаю такую огласку от этого
cog::шестеренка
affluent::благополучный
grab::захватывать
mahogany::красное дерево
insecurities::неуверенность
squire::ухаживать
accustomed::привыкший
seams::швы
and i started to get fearful about what she was up to::и я начал бояться того, что она задумала
engulfed::охваченный
gripped::захваченный
apprehension::тревога
as far as i was concerned, it was new territory::что касается меня, то это была новая территория
horrendous::ужасный
i had this connection with law enforcement there::у меня там была связь с правоохранительными органами
this became blatantly obvious fairly early on in the series of murders::это стало очевидным довольно рано в серии убийств
would call me into his office sometimes to brainstorm::иногда звал меня к себе в кабинет, чтобы провести мозговой штурм
envisioned::представить
squeeze::прижаться
bundy i loved her so much it it was destabilizing::банди я так сильно ее любил это было дестабилизирующе
meek::кроткий
on occasion i would experience this fit of, you know::иногда я испытывал этот приступ, знаете ли
bachelor::холостяк
sling::повесить
what were her thoughts?::о чем она думала?
reassurances::заверения
skewed::перекошенный
militant::воинствующий
possessions::собственность
subservient::подчиненный
merchandise::товар
freer::халявный
reason::q1
apparently::q2
eventually::q3
pretend::q4
sore::q5
swelling::q6
